NO ./assets/bluestone.xpm
SO ./assets/greystone.xpm
WE ./assets/mossy.xpm
EA ./assets/redbrick.xpm

F 100,100,50
C 225,30,60

1111111111111111111111111
1000100000100000100000011
100P000000000000000000001
1000000000000000000000001
1000100000100000100000011
1111111111111111111111111