NO ./assets/bluestone.xpm
SO ./assets/greystone.xpm
WE ./assets/mossy.xpm
EA ./assets/redbrick.xpm

F 100,100,50
C 225,30,60

1111111111111111111111111
1000100000100000100000011
1P00000000000000000000011
1000100000100000100000001
1000100000100000100000011
1111111111111111111111111