NO ./assets/greystone.xpm
SO ./assets/bluestone.xpm
WE ./assets/mossy.xpm
EA ./assets/redbrick.xpm

F 100, 20,50
C 225,30, 200

1111111111111111111111111
1000000000100000100000011
1000000W00010000000000001
1000000000000000000000001
1000100000100000100000011
1111111111111111111111111