NO ./assets/bluestone.xpm
SO ./assets/greystone.xpm
WE ./assets/mossy.xpm
EA ./assets/redbrick.xpm

F 100,100,50
C 225,30,60

11111
10001
10P01
10001
11111