NO ./path_to_the_north_texture
SO ./path_to_the_south_texture
WE ./path_to_the_west_texture
EA ./path_to_the_east_texture

F 220,100,0
C 225,30,0

11111111111111111111111111111
10000000001000001000000100001
10001000001000001000000100001
1000100000000P000000000100001
10001000001000001000000000001
10001000001000001000000100001
10001000001000001000000100001
11111111111111111111111111111