


SO /home/giulio/Desktop/42_Cube3d/valid.cub 

    
WE /home/giulio/Desktop/42_Cube3d/valid.cub 
EA /home/giulio/Desktop/42_Cube3d/valid.cub

      F 220   ,     100, 0 
C       225     ,30,0   
NO /home/giulio/Desktop/42_Cube3d/valid.cub    

     1111111111111111111111111
     1000000000110000000000001
     1011000001110000000000001
     1001000000000000000000001
111111111011000001110000000000001
100000000011000001110111111111111
11110111111111011100000010001
11110111111111011101010010001
11000000110101011100000010001
100000000000000011000P0010001
10000000000000001101010010001
11000001110101011111011110N0111
11110111011101010101111010001
11111111111111111111111111111