NO ./assets/greystone.xpm
SO ./assets/bluestone.xpm
WE ./assets/mossy.xpm

F 100,100,50
EA ./assets/redbrick.xpm
C 225,30,60

          1111111111111111111111111
        1000000000110000000000001
        1011000001110000000000001
        1001000000000000000000111
111111111011000001110000000000011
100000000011000001110111111111111
11110111111111011100000010001
11110111111111011101010010001
11000000110101011100000010011
10000000000000001100000010001
10000000000000001101010010001
11000001110101011111011110N0111
1111011111101011101111010001
11111111 1111111 111111111111