NO ./assets/greystone.xpm
SO ./assets/bluestone.xpm
WE ./assets/mossy.xpm
F 100,100,50
EA ./assets/redbrick.xpm
C 225,30,60

         11 11111111111 11111111
        100100000110000100000001
        1011000001110000000000001
        1001000000000000000000111
111111111110000011100000000000001
100000000011000001110111111111101
111101111111110111000000100011111
1111011111111101110101000001
1100000011010101110000000011
1000000000000000110000000001
1000000000000000110101000001
1100000100101011111011110N0111
111101110010001110100111011
    111111 1111111111101111